l w l w g
w g w l w
g w g w l
w l w g w
r w g w l