l w r w l
w g w g w
g w l w g
w l w l w
g w l w g