l w l w l
w l w l w
l w g w g
w l w l w
r w l w l